ID	Type
Acanthisitta_chloris	X
Accipiter_gentilis_atricapillus	Y
Accipiter_gentilis	Y
Accipiter_nisus	Y
Acridotheres_javanicus	X
Acrocephalus_arundinaceus	X
Acrocephalus_scirpaceus_scirpaceus	X
Aegithalos_caudatus	X
Aegotheles_bennettii	X
Agapornis_roseicollis	X
Agelaius_phoeniceus	X
Agelaius_tricolor	X
Alauda_arvensis	X
Alaudala_cheleensis	X
Alca_torda	Y
Aleadryas_rufinucha	X
Alectoris_rufa	X
Alectura_lathami	Y
Alopecoenas_beccarii	X
Amazona_aestiva	X
Amazona_collaria	X
Amazona_guildingii	X
Amazona_vittata	X
Amblyornis_subalaris	X
Ammodramus_savannarum_pratensis	X
Anas_platyrhynchos_platyrhynchos	X
Anas_platyrhynchos	X
Anas_zonorhyncha	X
Anhinga_anhinga	Y
Anhinga_rufa	X
Anodorhynchus_hyacinthinus	Y
Anomalopteryx_didiformis	Z
Anseranas_semipalmata	X
Anser_brachyrhynchus	X
Anser_cygnoides_domesticus	X
Anser_cygnoides	X
Anser_indicus	Y
Anthochaera_phrygia	X
Anthoscopus_minutus	X
Antigone_vipio	Y
Antrostomus_carolinensis	Y
Apaloderma_vittatum	X
Aphelocoma_coerulescens	X
Aptenodytes_forsteri	Y
Aptenodytes_patagonicus	Y
Apteryx_haastii	Z
Apteryx_mantelli_mantelli	Z
Apteryx_owenii	Z
Apteryx_rowi	Z
Apus_apus	X
Aquila_chrysaetos_canadensis	Y
Aquila_chrysaetos_chrysaetos	Y
Aquila_chrysaetos_japonica	Y
Ara_ararauna	X
Ara_chloropterus	X
Ara_glaucogularis	Y
Ara_macao	X
Ara_militaris	X
Aramus_guarauna	Y
Aratinga_solstitialis	X
Aratinga_weddellii	X
Ardeotis_arabs	X
Ardeotis_kori	X
Arenaria_interpres	Y
Asarcornis_scutulata	X
Athene_cunicularia	Y
Atlantisia_rogersi	X
Atrichornis_clamosus	X
Aythya_fuligula	Y
Balaeniceps_rex	Y
Balearica_regulorum_gibbericeps	Y
Bambusicola_thoracicus	X
Baryphthengus_martii	X
Bombycilla_garrulus	X
Brachypodius_atriceps	X
Brachypteracias_leptosomus	Y
Branta_canadensis	X
Bubo_blakistoni	Y
Bubo_bubo	Y
Bubo_scandiacus	Y
Bucco_capensis	X
Buceros_rhinoceros_silvestris	X
Bucorvus_abyssinicus	X
Buphagus_erythrorhynchus	X
Burhinus_bistriatus	Y
Burhinus_oedicnemus	Y
Buteo_japonicus	Y
Cairina_moschata_domestica	X
Cairina_moschata	Y
Calcarius_ornatus	X
Calidris_pugnax	Y
Calidris_pygmaea	Y
Callaeas_wilsoni	X
Callipepla_squamata	X
Caloenas_nicobarica	X
Calonectris_borealis	Y
Calypte_anna	X
Calyptomena_viridis	X
Camarhynchus_parvulus	X
Campylorhamphus_procurvoides	X
Caprimulgus_europaeus	X
Cardinalis_cardinalis	X
Cariama_cristata	Y
Casuarius_casuarius	Y
Cathartes_aura	Y
Catharus_fuscescens	X
Catharus_ustulatus	X
Centrocercus_minimus	X
Centrocercus_urophasianus	Y
Centropus_bengalensis	X
Centropus_unirufus	X
Cephalopterus_ornatus	X
Cepphus_grylle	Y
Cercotrichas_coryphoeus	X
Certhia_americana	X
Certhia_brachydactyla	X
Certhia_familiaris	X
Cettia_cetti	X
Ceuthmochares_aereus	X
Ceyx_cyanopectus	X
Chaetops_frenatus	X
Chaetorhynchus_papuensis	X
Chaetura_pelagica	X
Charadrius_alexandrinus	Y
Charadrius_vociferus	Y
Chauna_torquata	X
Chionis_minor	Y
Chiroxiphia_lanceolata	X
Chlamydotis_macqueenii	X
Chlamydotis_undulata_undulata	X
Chloebia_gouldiae	X
Chloroceryle_aenea	X
Chlorodrepanis_virens	X
Chloropsis_cyanopogon	X
Chloropsis_hardwickii	X
Chordeiles_acutipennis	Y
Chroicocephalus_maculipennis	Y
Chrysolophus_pictus	Y
Chunga_burmeisteri	Y
Ciccaba_nigrolineata	Y
Cicinnurus_regius	X
Ciconia_boyciana	Y
Ciconia_maguari	Y
Cinclus_mexicanus	X
Circaetus_pectoralis	Y
Cisticola_juncidis	X
Climacteris_rufus	X
Cnemophilus_loriae	X
Cochlearius_cochlearius	Y
Colaptes_auratus	X
Colinus_virginianus	X
Colius_striatus	X
Coloeus_monedula	X
Columba_janthina_nitens	X
Columba_livia	X
Columbina_picui	X
Copsychus_sechellarum	X
Corapipo_altera	X
Corvus_brachyrhynchos	X
Corvus_cornix_cornix	X
Corvus_hawaiiensis	X
Corvus_kubaryi	X
Corvus_macrorhynchos	X
Corvus_moneduloides	X
Corythaeola_cristata	Y
Corythaixoides_concolor	Y
Coturnix_japonica	X
Crossoptilon_mantchuricum	X
Crotophaga_sulcirostris	X
Crypturellus_cinnamomeus	Z
Crypturellus_soui	Z
Crypturellus_undulatus	Z
Cuculus_canorus	X
Cyanistes_caeruleus	X
Cyanoderma_ruficeps	X
Cygnus_atratus	X
Cygnus_buccinator	Y
Cygnus_cygnus	Y
Cygnus_olor	Y
Daphoenositta_chrysoptera	X
Dasyornis_broadbenti	X
Dendrocopos_noguchii	X
Dicaeum_eximium	X
Dicrurus_megarhynchus	X
Diglossa_brunneiventris	X
Diphyllodes_magnificus	X
Donacobius_atricapilla	X
Dromaius_novaehollandiae	Z
Dromas_ardeola	Y
Drymodes_brunneopygia	X
Dryobates_pubescens	X
Dryoscopus_gambensis	X
Eclectus_roratus	X
Edolisoma_coerulescens	X
Egretta_garzetta	Y
Elachura_formosa	X
Emberiza_fucata	X
Empidonax_traillii	X
Entomyzon_cyanotis	X
Eolophus_roseicapilla	X
Eopsaltria_australis	X
Eremophila_alpestris_peregrina	X
Erithacus_rubecula	X
Erpornis_zantholeuca	X
Erythrocercus_mccallii	X
Eubucco_bourcierii	X
Eudromia_elegans	Z
Eudyptes_chrysocome	Y
Eudyptes_chrysolophus	Y
Eudyptes_filholi	Y
Eudyptes_moseleyi	Y
Eudyptes_pachyrhynchus	Y
Eudyptes_robustus	Y
Eudyptes_schlegeli	Y
Eudyptes_sclateri	Y
Eudyptula_albosignata	Y
Eudyptula_minor	Y
Eudyptula_novaehollandiae	X
Eulacestoma_nigropectus	X
Eupsittula_pertinax	X
Eurypyga_helias	X
Eurystomus_gularis	Y
Falco_cherrug	Y
Falco_naumanni	Y
Falco_peregrinus	Y
Falco_rusticolus	Y
Falco_tinnunculus	Y
Falcunculus_frontatus	X
Ficedula_albicollis	X
Formicarius_rufipectus	X
Fratercula_arctica	Y
Fratercula_cirrhata	Y
Fregata_magnificens	Y
Fregetta_grallaria	Y
Fringilla_coelebs_coelebs	X
Fulica_atra	X
Fulmarus_glacialis	Y
Furnarius_figulus	X
Galbula_dea	X
Gallirallus_okinawae	X
Gallus_gallus	Y
Gavia_stellata	X
Geococcyx_californianus	X
Geospiza_fortis	X
Geothlypis_trichas	X
Glareola_pratincola	X
Glaucidium_brasilianum	Y
Gorsachius_goisagi	X
Grallaria_varia	X
Grantiella_picta	X
Grus_americana	Y
Grus_japonensis	Y
Grus_monacha	Y
Grus_nigricollis	Y
Guaruba_guarouba	X
Gymnogyps_californianus	Y
Gymnorhina_tibicen	X
Halcyon_senegalensis	Y
Haliaeetus_albicilla	Y
Haliaeetus_leucocephalus	Y
Haliaeetus_pelagicus	Y
Heliornis_fulica	Y
Hemignathus_wilsoni	X
Hemiprocne_comata	X
Herpetotheres_cachinnans	Y
Heteronetta_atricapilla	Y
Himantopus_himantopus	Y
Himantopus_leucocephalus	Y
Hippolais_icterina	X
Hirundo_rustica	X
Hirundo_rustica_rustica	X
Horornis_vulcanius	X
Hylia_prasina	X
Hypocryptadius_cinnamomeus	X
Ibidorhyncha_struthersii	Y
Ifrita_kowaldi	X
Illadopsis_cleaveri	X
Indicator_maculatus	X
Irena_cyanogastra	X
Jacana_jacana	X
Junco_hyemalis	X
Lagopus_leucura	X
Lagopus_muta_japonica	Y
Lamprotornis_superbus	X
Lanius_collurio	X
Lanius_ludovicianus	X
Larus_smithsonianus	X
Leiothrix_lutea	X
Lepidothrix_coronata	X
Leptocoma_aspasia	X
Leptosomus_discolor	Y
Leucopsar_rothschildi	X
Lichenostomus_cassidix	X
Limosa_lapponica_baueri	Y
Locustella_ochotensis	X
Lonchura_striata_domestica	X
Lophochroa_leadbeateri	X
Lophotis_ruficrista	X
Lophura_nycthemera	Y
Lorius_garrulus	Y
Loxia_curvirostra	X
Loxia_leucoptera	X
Lycocorax_pyrrhopterus_obiensis	X
Lyrurus_tetrix_tetrix	X
Machaerirhynchus_nigripectus	X
Malurus_cyaneus_samueli	X
Malurus_elegans	X
Manacus_vitellinus	X
Megadyptes_antipodes_antipodes	Y
Melanerpes_aurifrons	Y
Melanocharis_versteri	X
Meleagris_gallopavo	X
Melopsittacus_undulatus	X
Melospiza_melodia	X
Melospiza_melodia_maxima	X
Menura_novaehollandiae	X
Merops_nubicus	X
Mesembrinibis_cayennensis	Y
Mesitornis_unicolor	Y
Mionectes_macconnelli	X
Mixornis_gularis	X
Mohoua_ochrocephala	X
Molothrus_ater	X
Montifringilla_adamsi	X
Motacilla_alba_alba	X
Motacilla_alba	X
Motacilla_tschutschensis	X
Myiagra_hebetior	X
Myiopsitta_monachus	X
Mystacornis_crossleyi	X
Neodrepanis_coruscans	X
Neopelma_chrysocephalum	X
Neopipo_cinnamomea	X
Nesospiza_acunhae	X
Nestor_notabilis	Y
Nettapus_auritus	Y
Nicator_chloris	X
Nipponia_nippon	Y
Nisaetus_nipalensis	Y
Nothocercus_julius	Z
Nothocercus_nigrocapillus	Z
Nothoprocta_ornata	Y
Nothoprocta_pentlandii	Y
Nothoprocta_perdicaria	Y
Notiomystis_cincta	X
Numida_meleagris	X
Nyctibius_bracteatus	X
Nyctibius_grandis	X
Nycticryphes_semicollaris	Y
Nyctiprogne_leucopyga	Y
Nymphicus_hollandicus	X
Oceanites_oceanicus	Y
Oceanodroma_tethys	Y
Odontophorus_gujanensis	X
Oenanthe_oenanthe	X
Onychorhynchus_coronatus	X
Onychostruthus_taczanowskii	X
Opisthocomus_hoazin	Y
Oreocharis_arfaki	X
Oreotrochilus_melanogaster	X
Origma_solitaria	X
Oriolus_oriolus	X
Orthonyx_spaldingii	X
Otus_sunia	Y
Oxylabes_madagascariensis	X
Oxyruncus_cristatus	X
Oxyura_jamaicensis	Y
Pachycephala_philippinensis	X
Pachyramphus_minor	X
Pandion_haliaetus	X
Panurus_biarmicus	X
Paradisaea_raggiana	X
Paradisaea_rubra	X
Pardalotus_punctatus	X
Parotia_lawesii	X
Parus_major	X
Passer_domesticus	X
Passerina_amoena	X
Passer_montanus	X
Patagioenas_fasciata_monilis	X
Pavo_cristatus	Y
Pavo_muticus	Y
Pedionomus_torquatus	Y
Pelecanoides_urinatrix	Y
Pelecanus_crispus	X
Penelope_pileata	X
Peucedramus_taeniatus	X
Phaethon_lepturus	Y
Phaetusa_simplex	Y
Phainopepla_nitens	X
Phalacrocorax_auritus	Y
Phalacrocorax_brasilianus	Y
Phalacrocorax_carbo	Y
Phalacrocorax_harrisi	Y
Phalacrocorax_pelagicus	X
Phasianus_colchicus	Y
Pheucticus_melanocephalus	X
Phoebastria_albatrus	Y
Phoenicopterus_ruber_ruber	Y
Phylloscopus_plumbeitarsus	X
Phylloscopus_trochiloides_trochiloides	X
Phylloscopus_trochiloides_viridanus	X
Phylloscopus_trochilus_acredula	X
Phylloscopus_trochilus_trochilus	X
Phylloscopus_whistleri	X
Piaya_cayana	X
Picathartes_gymnocephalus	X
Pionus_senilis	X
Pipra_filicauda	X
Piprites_chloris	X
Pitta_sordida	X
Platysteira_castanea	X
Ploceus_nigricollis	X
Pluvialis_apricaria	Y
Pluvianellus_socialis	Y
Podargus_strigoides	X
Podiceps_cristatus	Y
Podilymbus_podiceps	X
Poecile_atricapillus	X
Pogoniulus_pusillus	X
Pogoniulus_pusillus_pusillus	X
Polioptila_caerulea	X
Pomatorhinus_ruficollis	X
Pomatostomus_ruficeps	X
Porphyrio_hochstetteri	X
Prinia_subflava	X
Probosciger_aterrimus	X
Promerops_cafer	X
Prunella_fulvescens	X
Prunella_himalayana	X
Pseudopodoces_humilis	X
Pseudorectes_ferrugineus	X
Psilopogon_haemacephalus	X
Psittacula_krameri	X
Psittacus_erithacus	X
Psittacus_timneh	X
Psitteuteles_goldiei	Y
Psophia_crepitans	X
Pterocles_burchelli	X
Pterocles_gutturalis	X
Pterocles_orientalis	X
Pteruthius_melanotis	X
Ptilonorhynchus_violaceus	X
Ptilorrhoa_leucosticta	X
Pycnonotus_jocosus	X
Pygoscelis_adeliae	Y
Pygoscelis_antarcticus	Y
Pygoscelis_papua	Y
Pyrgilauda_ruficollis	X
Pyrrhura_cruentata	X
Pyrrhura_frontalis	X
Pyrrhura_griseipectus	X
Pyrrhura_lepida	X
Pyrrhura_molinae	X
Pyrrhura_perlata	X
Quiscalus_mexicanus	X
Ramphastos_sulfuratus	X
Recurvirostra_avosetta	Y
Regulus_satrapa	X
Rhabdornis_inornatus	X
Rhadina_sibilatrix	X
Rhagologus_leucostigma	X
Rhea_americana	Z
Rhea_pennata	Z
Rhegmatorhina_hoffmannsi	X
Rhinopomastus_cyanomelas	Y
Rhinoptilus_africanus	Y
Rhipidura_dahli	X
Rhodinocichla_rosea	X
Rhynochetos_jubatus	Y
Riparia_riparia	X
Rissa_tridactyla	Y
Rostratula_benghalensis	X
Rynchops_niger	X
Sagittarius_serpentarius	Y
Sakesphorus_luctuosus	X
Sapayoa_aenigma	X
Saxicola_maurus_maurus	X
Sclerurus_mexicanus	X
Scolopax_mira	Y
Scopus_umbretta	Y
Scytalopus_superciliaris	X
Semnornis_frantzii	X
Serilophus_lunatus	X
Serinus_canaria	X
Setophaga_coronata_coronata	X
Setophaga_kirtlandii	X
Sialia_sialis	X
Sinosuthora_webbiana	X
Sitta_europaea	X
Smithornis_capensis	X
Spheniscus_demersus	Y
Spheniscus_humboldti	Y
Spheniscus_magellanicus	Y
Spheniscus_mendiculus	Y
Spizaetus_tyrannus	X
Spizella_passerina	X
Sporophila_hypoxantha	X
Steatornis_caripensis	Y
Stercorarius_parasiticus	Y
Sterna_hirundo	Y
Sterrhoptilus_dennistouni	X
Stictonetta_naevosa	Y
Streptopelia_turtur	X
Strigops_habroptila	Y
Strix_nebulosa	Y
Strix_occidentalis_caurina	Y
Struthidea_cinerea	X
Struthio_camelus_australis	Z
Sturnus_vulgaris	X
Sula_dactylatra	Y
Sylvia_atricapilla	X
Sylvia_borin	X
Sylvietta_virens	X
Syrmaticus_mikado	X
Syrrhaptes_paradoxus	X
Tachuris_rubrigastra	X
Tachycineta_bicolor	X
Taeniopygia_guttata	X
Tauraco_erythrolophus	Y
Tetrax_tetrax	X
Thalassarche_chlororhynchos	Y
Theristicus_caerulescens	Y
Thinocorus_orbignyianus	Y
Thryothorus_ludovicianus	X
Tichodroma_muraria	X
Tinamus_guttatus	Z
Todus_mexicanus	X
Toxostoma_redivivum	X
Tricholaema_leucomelas	X
Trogon_melanurus	Y
Trogon_surrucura	X
Turdus_rufiventris	X
Turnix_velox	X
Tympanuchus_cupido_pinnatus	X
Tyrannus_savana	X
Tyto_alba_alba	Y
Tyto_alba	Y
Upupa_epops	X
Uria_aalge	Y
Uria_aalge_inornata	Y
Uria_lomvia	Y
Urocolius_indicus	X
Urocynchramus_pylzowi	X
Vidua_chalybeata	X
Vidua_macroura	X
Vireo_altiloquus	X
Willisornis_vidua_nigrigula	X
Xiphorhynchus_elegans	X
Zapornia_atra	Y
Zonotrichia_albicollis	X
Zosterops_borbonicus	X
Zosterops_hypoxanthus	X
Zosterops_japonicus	X
Zosterops_lateralis_melanops	X
Zosterops_pallidus	X
